1111111111
1000000P01
1000000001
1000C00001
1001010E01
1111111111