111111111111111111
100000000000000001
100000000000000001
100000000010000001
1P00000001C10000E1
111111111111111111