1111111111
1000000101
10000010E1
10C0000011
1001011P11
1111111111